wwwwwwwwwwwwwwwwwwwwwwww
w p                    w
w                      w
w                      w
w                      w
w                      w
w                      w
w                      w
w                      w
w                      w
w        wew           w
w       w   w          w
w       w  ew          w
w       w   w          w
w       wewww          w
w        w             w
w                    g w
w                      w
w                      w
wwwwwwwwwwwwwwwwwwwwwwww